

F   34,41,43

  EA ./images/colorstone.xpm


SO ./images/mossy.xpm
WE ./images/purplestone.xpm
NO ./images/greystone.xpm

    C         3,190,252


      111111111111111111111111111111
        10000000001100000000000011
         10110000011100000000000101
      1111100100000000000000000000111
        111100000001111111101111111111
         10000100000101000011110001
1111111110110000011100000000111110011
10000000000000100111011111111111111
11110111100000E00000000010001
11110111111111111101010000001
11000000110101011100000000001
100000000000000011000000000001
10000000000000001101010010001
110000011111010111110111100011111
111111111   111101111 11111111111 
11111111    1111111 111111111111
