
F   0,0,0

  NO ./images/square-64.xpm


SO ./images/square-64.xpm
WE ./images/square-64.xpm
EA ./images/square-64.xpm

    C         255,255,255

               1
              101
             11111
            1000001
           1000S0001
     111111000000000111111
     100000001000000000001
     100001001000111000001
     100011101000101000001
     100011001000101110001
      1011100000000011101
     100011000101000110001
 1111000000000101000000000111111
100000000000001010111000000000001
 1111000000000101000000000111111
     100000000000000000001
      1000000010100000001
       10000001010000001
        100000101000001
         1000010100001
          10001010001
          10001010001
          10001010001
           100000001
            1111111
