
F   0,0,0

  EA ./images/colorstone.xpm


SO ./images/mossy.xpm
WE ./images/purplestone.xpm
NO ./images/greystone.xpm

    C         255,255,255

 11111111111111
1000000000000001
100000N000000001
1000000000000001
1000000000000001
1000000000000001
1000000001000001
1000000000000001
 11111111111111
